R	352 480

11111111111
10000000001
10000000001
11110000001
10000000001
10000100001
10010000001
10000000001
10000000001
10000000001
11111111111